AAAAAAAAAAAAAAAAAAAAAAAAAAAAAAAAAAAAAAAAAAAAAAAAAAAAAAAAAAAAAAAAAAAAAAAAAAAAAAAAAAAAAAAAAAAAAAAAAAAAAAAAAAAAAAAAAAAAAAAAAAAAAAAAAAAAAAAAAAAAAAAAAAAAAAAAAAAAAAAAAAAAAAAAAAAAAAAAAAAAAAAAAAAAAAAAAAAAAAAA
AAAAAAAAAAAAAAAAAAAAAAAAAAAARRRRRRRR.AAAAAAAAAAAAAAAAAAAAAAAAAAAAAAAAAAAAAAAAAAAAAAAAAAAAAAAAAAAAAAAAAAAAAAAAAAAAAAAAAAAAAAAAAAAAAAAAAAAAAAAAAAAAAAAAAAAAAAAAAAAAAAAAAAAAAAAAAAAAAAAAAAAAAAAAAAAAAAAAAAA
AAAAAAAAAAAAAAAAAAAAA.AAAARRRRRRRRRRRRAAAAAAA.RRAAAAARAAAAAAAAAAAAAAAAAAAAAAAAAAAAAAAAAAAAAAAAAAAAAAAA.RAARRAAAAAARAAAAAAAAAAAAAAAAAAAAAAAAAAAAAAAAAAAAAAAAAAAAAAAAAAAAAAAAAAAAAAAAAAAAAAAAAAAAAAAAAAAAA
AAAAAAAAAAAAAAAA.AR.RRRRRRRRRRRRRRRRRRRRR.RRRRRRRRRRRRRRRRAAAAAAAAAAAAAAAAAAAAAAAAAAAAAAAAAAAAAAAAAAARA.RRRRRRRRM.RR.RAARAAAAAAAAAAAAAAAAAAAAAAAAAAAAAAAAAAAAAAA.AAAAARRRRRRRRRRRR.RRRRRRAAAAAAAAAAAAAAA
AAAAAAAAAAAAAAA.RRRRRRRRRRMRRMMMRMRMMMRRRRRRMMMRMMMMRRRRR.AAAAAAAAAAAAAAAAAAAAAAAAAAAAAAAAAAAAAAAAAARRRRA.RRRRRRRRRRRRRRRRRRRRRRRRRRRRRRRA.AAA.RAAAAAAAAARAARRRRRRRR.RRRRRRRRRRRRRRRRRRRRRRAAAAAAAAAAAAA
AAAAAAAAAAAAAAARRRRRMMMMMMMMMMMMMMMMMMMMMMMMMMMMMMMMRRRRAAAAAAAAAAAAAAAAAAAAAAAAAAAAAAAAAARAAAAARRRRMMMMMR...R.R.RR.RRRRRRRMMMMMMMMMMRMMRRRMMRRRRRRR.R.A.RRRRRRRRRARRRRRRRRRRRRRRRRRRRRRRRRRR.AAAAAAAAAA
AAAAAAAAAAAAAAARR...RFRMMMMMMMMMMMMMMMMMMMMMRMFFFFF...RRRAAAAAAAAAAAAAAAAAAAAAAAAAAAAAAARRRRAARRRRRMMMMMM.RA.A..R..9MMMMMMMMMMMMMMMMMMMMMMMMMMMMMMMRMMMMMMRRRRRRRAARRRRMMMRRRRRRRRRRRRRRRRRRRRRRAAAAAAAA
AAAAAAAAAAAAAAA.....RFFFRFFFFFFFFFFFFFFMMMMFFFFFFFR...R.AAAAAAAAAAAAAAAAAAAAAAAAAAAARRRRMMMMMM.ACRMMMMMMMMM.A..R....MMMMMMMMMMMMMMMMMMMMMMMMMMMMMMMMMMMMRRRRMMMMRRRRRMMMMMMMMMMMMMRRRRRRRRRRRRRR.AAAAAAA
AAAAAAAAAAAAAAAARR......FFFFFFFFFFFFFFA..FRFFFFFRRR..AAAAAAAAAAAAAAAAAAAAAAAAARRRRRRRMMMMMMMMARR.MM.RMMRMMM.R...MMMMMMMMMMMMMMMMMMMMMMMMMMMMMMMMMMMMMMMMMRRRMMMMMMMMRRRMMMMMMMMMMM...MM.MMMMMMRRRRAAAAAA
AAAAAAAAAAAAAAAAA.R............RFFFFFFARR.FFFF.RRRAAAAAAAAAAAAAAAAAAAAAAAAAARRRMMMMMMMMMRMMMA.FFFRMMMMMMMMMMM....MMMMMMMMMMMMMMMMMMMMMMMMMMMMMMMMMMMMMMMMMMMMMMMMFFFFFF.MMMMMMMMMMMMMMMM.FFFFFR..M.MRAAA
AAAAAAAAAAAAAAAAAAAAR...RR........RAAAAAAR.AAAAAAAAAAAAAAAAAAAAAAAAAAAAAARRRRMR..........M..R..FF.RMMM..RFFFFFFMMMMMMMMMMMMMMMMMMMMMMMMMMMM.....R.......MMMMMMMMMMM.FFFF.MMMMMMMMMM..FFFFFFFFFFFF....AAA
AAAAAAAAAAAAAAAAAAAAAAAA.A.RR.AR.AAAAAAAAAAAAAAAAAAAAAAAAAAAAAAAAAAAAA.R...MMM..RMMRR.....R...RA..FFFFAAFFFFFFFFFFFFMMMMMMMMMMMMMMMMMMMMMMMM..........MMMMMMMMMMMM...R..R.R.R......FFFFFFFFFFFFFF...AAAA
AAAAAAAAAAAAAAAAAAAAAAAAAAAAAAAAAAAAAAAAARAAAAAAAAAAAAAAAAAARRAAAA.R...MRMMMMMFMRMR.R..RR..........A..RFFFFF...FFFFFFFFFFFFFFMRMMRM.A..........M.MMMMMMMMMMM..R.RRFFFRRFRFFF..AAAA.FFFFFFFFFF......AAAAA
AAAAAAAAAAAAAAAAAAAAAAAAAAAAAAAAARAR.RRRFFFRAAAAAAAAAAA.A.R...RRR.R.RRFFFFFFFR.R................RA.RFFFA.RR......FFFFFFFFFFFFFFFFFAAA.....MMMMMMFFFFRFFFFFFFFFFFFFFFFFFFFFFFF.RFF.RFR......RRAR..AAAAAAA
AAAAAAAAAAAAAAAAAAAAAAAAAARRRR....FFFFFFFFFFFR.....AR.....M.....R...FF.R........FFFFFFFFF......R..FFFRRR..........RFFFFFFFFFFFFFFFFFFR....MMMMMRFFFFFFFFFFR.FFFFFFFFFFFFFFFFFF.A.RFR.......RAAAAAAAAAAAA
AAAAAAAAAAAAAAAAAAAAA.R...FRFFFFFFFFFFFFFFFRR......MM..............R....R...R...RFFFFFFR........A.RR...FFFF..4.....FFFFFFFFFFFFFFFFFFF....................FFFFFFFFFFFFFFFFFFFFFARRRAR.AR.AAAAAAAAAAAAAAA
AAAAAAAAAAAAAAAAAAAA....FFFFFFFFFFFFFFFFFFFFFF.R..RM........MR...............FFFR.FFFRR..............A...FFF.......FFFFFFFFFFFFFFFFFF.........R..........RFFFFFFFFFFFFFFFFFFRFFFFFRFFFFFRAAAAAAAAAAAAAAA
AAAAAAAAAAAAAAAAAAA....FFFFFFFFFFFFFFFFFFFFFFFFRR.R..R.....R....RMMR..R...RFFF.......................R....RR....FFFFFFFFFFFFFFFFFFFFF........R...MMM...RFFFFFFFFFFFFFFFFFFFFFFFFF..MM.M.RAAAAAAAAAAAAAAA
AAAAAAAAAAAAAAAAAA..A...RFFFFFFFFFFFFR.....R.RRR..R.R...RR...M...R.......................R..R.......RAAR..FFF.RFFFFFFFFFFFFFFFFFFFFFFFFFRF......MM.MR....RFFFFFFFFFFFFFFFFFFFF.R.MMMMM.RAAAAAAAAAAAAAAAA
AAAAAAAAAAAAAAAAAAAR..FFFFFFFFFFFFFFFRR...FR...MMM..M.......R.......FFFFFF..R..........M.R...R.RR......FFFFFFFFFFFFFFFFFFFFFFFFFFFFFFFFFFFFR..................FF..FFFFFFFF.RF...RMMM...RAAAAAAAAAAAAAAAA
AAAAAAAAAAAAAAA.MRR.R....R..FFFFFFFFFFA.RFFFF...MMMMMMMMMMM.....RFFFFFFFFF......................A....RFFFFFFFFFFFFFFFFFFFFFFFFFFFFFFFFFFFFFFFFFFFRFF..............RFFFFRR.......RMM.MR.AAAAAAAAAAAAAAAAA
AAAAAAAAAAAAAAR.R..R.FFFFR.A.RFFFFFFARR.FFFF....MMMMMMMMMM.MFFFFFFFFFFFFFFFR.........................R.RFFFFFFFRR.................FFFFFFFFFFFFFFFFFF.........R..M.R.......R....MMMMMM..AAAAAAAAAAAAAAAAA
AAAAAAAAAAAAR..RFFFFFFFFFFRARFFFFFFFAR.FFFRAAA.FFFFFFRMMMMMFFFFFFFFFFFFFFFFF...R..R.........RR3..........FFFRF........R...............FFRAAAFRFF.........R..R.RRM.R.RR..R....RMMMMMMM...RAAAAAAAAAAAAAAA
AAAAAAAAAA...FFFFFFFFFFFFFF....RFFFFAR..FFRR.RFFFFFFFFMMMMMFFFFFR..FFFFFF......R.MM....R...........RR...............RR......R.........FFFFFFFFFF.........................MMRMMMMMMMM....AAAAAAAAAAAAAAAA
AAAAAAAAR...RFFFFFFFFFFFFFFFFRAA.FFFAR..FRFR....RAARFFFFFFFFFFFAAA..RFF.................................R.............R..R.R...........FFFFFFFFR...FF..........R...R.MR.....MMMMMMM....RAAAAAAAAAAAAAAAA
AAAAAA.R..FFFFFFFFFFFFFFFFFFFFFARFFAR.R.RRFFAAAAAAARR...F....R...RRR.............R.................R.R.....M...R...........MR.R..R...R..FFFFFFF..................MR......MMMMMMMMMMMR..RAAAAAAAAAAAAAAAA
AAAAA...FFFFFFFFFFFFFFRD....FRAAR.RAAAAAA..RAAAAAAAAA......................R.......................RR...............R.R.....MR.RMM...R...............................R...MMMMMMMMM...RAAAAAAAAAAAAAAAAAA
AAAA.R..FFFRFFFFFFR.FFFFF..R..RAAAAAAAAAAAAAAAAAAAAAAAA..............R.......6......R..RRRRR.RR...R...........R....R........MRR.RR.....FFFFFFFF....FFFFFFFFFFFFRR....R.......M.MMMM.M.AAAAAAAAAAAAAAAAAA
AAAAAA.R.FFFFFFFFF..FFFFF..AAAAAAAAAAAAAAAAAAAAAAAAAAAAAAAA.....RFFFFFFF.R..R..R........R...MMM..RR...RR.RMRR...............RR.R.......FFFFFFFF....FFFFFFFFFFFFFFFFFFFFFFR..MMMMMMMMMM.AAAAAAAAAAAAAAAAA
AAAARR.RFFFFFFFFFF.FFFFF..R.AAAAAAAAAAAAAAAAAAAAAAAAAAAAAAAAA.RARFFFFFFFR....R...MMMMMMMMMMMMMMMMM..RRARRRRR.RA.RR.......R.R.RR........FFFFFFFFR.......FFFFFFFFFFFFFFFFFFFFF....MMM..R..AAAAAAAAAAAAAAAA
AAAA.R.FFFFFFFFFFR..FFFF....AAAAAAAAAAAAAAAAAAAAAAAAAAAAAAAAAAR.A..R....R..RRRMMMMMMMMMMMMMMMMMMMMMM....A...R..RM...M.R................FFFFFFFFFF....R...FFFFFFFFFFFFFFFF....MMMRAAAAAAAAAAAAAAAAAAAAAAA
AAAA.R.FFFFFFFFFF.........R..AAAAAAAAAAAAAAAAAAAAAAAAAAAAAAAAAAA..AAA...R.ARR.R.....MMMMMMMMMMMMMMMMMMM....M.R...MRRR.R..............RFFFFFFFFFFFFFF.AR....RFFFFR....I......R.RRAAAAAAAAAAAAAAAAAAAAAAAA
AAAA.R.RFFFFFFFF.........RAR...ARAAA.AARA.AAAAAAAAAAAAAAAAAAAAAAAAAAAAAAAARR...5.RMMM.MMMMMMMMMMMMMMMMMR....RR.RR...R.MMMMR..FFFFFFFFFFFFFFFFFFFFFFFF.A...FFFF.FFFF......R....AAAAAAAAAAAAAAAAAAAAAAAAAA
AAAAA..RFFFFRR....R......RA......MMMRMMMMM....ARRAAAAAAAAAAAAAAAAAAAAAAAAARR......R.RMMMMMMMMMMMMMMMMMMM.......RR......RMMMRRR....RFFFFFFFFFFFFFFFR...R....FFFFFFFFFFFFFRR...AAAAAAAAAAAAAAAAAAAAAAAAAAA
AAAAAR.FFFA....RR.....R..A.R...MMMMMMMMMMMMMM......AAAAAAAAAAAAAAAAAAAAAA.....MMM...R.MMRMM......MMMMMMMM.M.RRA.....MMMMMMMR...........FFFFF...R......ARFRRRFRRFRRFRRR.FFR...AAAAAAAAAAAAAAAAAAAAAAAAAAA
AAAAAAR..A...RR.R.R.RA.R..........MMMMMMMMMMMMM....AAAAAAAAAAAAAAAAAAAAAAARR.........RM...RMM.M...MMMMMMMMMR........MMMMMRR..MMM.R.....R.............RAAA.FFFFFFFFFFFAARAAAAAAAAAAAAAAAAAAAAAAAAAAAAAAAA
AAAAAAA......R..AR..RRRRFFFFAA.AR..MMMMMMMMMMMMMMMM.RAAAAAAAAAAAAAAAAAAAAAAA.........MR..MM.RR.M..R..M.MM...RR.R.R.RMMM.R.M.MMMMMRMMR.R......R..RRR.RR...AAAAAARRAAAAAAAAAAAAAAAAAAAAAAAAAAAAAAAAAAAAAAA
AAAAAAARAR.......RFFFFFFFFFFR...A....RMMMMMMMMMMMMMMMM...RAAAAAAAAAAAAAAAAAAAAAAA...R.R...M.RMRR...R........ARRR..MMMMMMMMMMMMRMMMMMMMRMMMMRR....R.M...AAAAAAAAAAAAAAAAAAAAAAAAAAAAAAAAAAAAAAAAAAAAAAAAA
AAAAAAAA.......RR..FFFFFFFFFFRR..RR..RRRMMMMMMMMMMMMMMMMMM...AAAAAAAAAAAAAAAAAAAAAA..................MMR...A.....MMRR.MMMMMMM..R..MMMMMMMMMMMM...AAR.AAAAAAAAAAAAAAAAAAAAAAAAAAAAAAAAAAAAAAAAAAAAAAAAAAA
AAAAAAAAAR.....A.R...FFFFFFFFFFFFFRA.R...MMMMMMMMMMMMMMMMMM..AAAAAAAAAAAAAAAAAAAAAAAAR..R....RAAR..AAAAAAAAAAAAR.......RR.RRRR...RRMMMMMMMMM..AAAAAMMM.AAAAAAAAAAAAAAAAAAAAAA..RRAAAAAAAAAAAAAAAAAAAAAAA
AAAAAAAAAAAAR...RRR....FRRFFFFFFFFFFRR..MMMMMMMMMMMMMRMM.....RAAAAAAAAAAAAAAAAAAAAAAAAAR....A.AAAAAAAAAAAAAAAAAAAAARR.R.AARM..MMMMMMMMMMMMMR.AR...RM.RAAAAAAAAAAAAAAAAAAAAAAAAAAAAAAAAAAAAAAAAAAAAAAAAAA
AAAAAAAAAAAAAAAARR..RFFFFFF.FFFFFFFFAR..MMMMMMMMM......R.R.AAAAAAAAAAAAAAAAAAAAAAAAAAAAAAAAAAAAAAAAAAAAAAAAAAAAAAAAAAAAAA..RRR....RMMMMMMM.AA.R...MRAAAAAAAAAAAAA.AAAAAAAAAAAAAAAAAAAAARR.AAAAAAAAAAAAAA
AAAAAA.R.AAAAAARRR.FFFFFFFFRRRR....R.R..MMMMMM....A.AAAAAAAAAAAAAAAAAAAAAAAAAAAAAAAAAAAAAAAAAAAAAAAAAAAAAAAAAAAAAAAAAAAAAA.R..............A.AAAAAAAAAAAAAAAAAAAAAAAAAAAAAAAAAAAAAAAAAA..E...AAAAAAAAAAAA
AAAAAAAA.AAAAAAR...FFFFFFFFFA.....RFF...MMMMMMMM.AAAAAAAAAAAAAAAAAAAAAAAAAAAAAAAAA.AAAAAAAAAAR.AAAAAAAAAAAAAAAAAAAAAAAAAAAAA...R..A.R..RAAAAAAAAAAAA...AAAAAAAAAAAAAAAAAA.R.AARAAAAAAAAA.R.RRAAAAAAAAAAA
AAAAAAAAAAAAAAA.R...............RFFFFFFFMMMMMMMMAAAAAAAAAAAAAAAAAAAAAAAAAAAAAAA....AA.AAAAAA....AAAAAAAAAAAAAAAAAAAAAAAAAAAAAAAAAAAAAAAAAAAAAAAAAAAARR...RAAAAAAAAAAAAA.....RAAAAAAAAAAAAAR..AAAAAAR.RAA
AAAAAAAAAAAAAAAA.R.AA....MMM.MM..RFFFFFFFMMMMMRMMR.RAAAAAAAAAAAAAAAAAAAAAAAAA.R..RR...R.R8M.MMRMMM...M.AAAAAAAAAAAAAAAAAAAAAAAAAAAAAAAAAAAAAAAAAAAAAAAA.RRR.RRAAAAAAARRR..R..AAAAAAAAAAAAA..AAAAAAAAAAAA
AAAAAAAAAAAAAAAAAAAAAAAAARRMMMMMM..FFFFFFMMMMMMMM.AAAAAAAAAAAAAAAAAAAAAAAAARRR.MM..MR..MR...R....MRMRAAAAAAAAAAAAAAAAAAAAAAAAAAAAAAAAAAAAAAAAAAAAAAAAAAAAAAAAAA.RA.R0.R.AAAAAAAAAAAAA..AAAAAAAAAAAAAAAAA
AAAAAAAAAAAAAAAAAAAAAAAA..RRMMMMMM.RFFFFFMMMMMMMMRAAAAAAAAAAAAAAAAAAAAAAA.R...M....MMM....R....MMMM.R.AAAAAAAAAAAAAAAAAAAAAAAAAAAAAAAAAAAAAAAAAAAAAAAAAAAA.B....RAARAAAA....RAAAAAAAAA.R...AAAAAAAAAAAAA
AAAAAAAAAAAAAAAAAAAAAAAAAR....MMMM.RRFFFF.MMMMMM.AAAAAAAAAAAAAAAAAAAAAAAR.....R.R..MMMMR.R...........RAAAAAAAAAAAAAAAAAAAAAAAAAAAAAAA..RAAAAAAAAAAAAAAAAAAAAAAAAAAAAAAAAAAAAAAAAAAAAAAAA...RR.RAAR.AAAAA
AAAAAAAAAAAAAAAAAAAAAAAAAA.R..MMMR..FFFFFMMMMMMAAAAAAAAAAAAAAAAAAAAAAAAR.....R..2RMMMR......MMMMMMR..MM..AAAAAAAAAAAAAAAAAAAAAAAAARR.........R.AAAAAAAAAAAAAAAAAAAAAAAAAAAAAAAAAAAAAAAAAAAAAA.AAAR...RAA
AAAAAAAAAAAAAAAAAAAAAAAAAAARRR.MMMMM.RFFFF.AR..AAAAAAAAAAAAAAAAAAAAAAAARR......M.......M.....R.....RR.R...AAAA.R...ARRAAA......RA..RAAAAAAAR....AAAAAAAAAAAAAAAAAAAAAAAAAAAAAAAAAAAAAAAAAAAAAAAAAAAAAAAA
AAAAAAAAAAAAAAAAAAAAAAAAAAR.....MMMMMM....RA..RAAAAAAAAAAAAAAAAAAAAAAAAR........A..R....RR.RRRRRMM......MAAAAA.........R.ARAR....AAAAAAAAAAAAAAA...AR.AAAAAAAAAAAAAAAAAAAAAAAAAAAAAAAAAAAAAAAAAAAAAAAAAA
AAAAAAAAAAAAAAAAAAAAAAAAAAAA.R..MMMMMM.M.1.FFFFAAAAAAAAAAAAAAAAAAAAAAAAARR...........AAAAAAA.R.........RAAAAAAA..RRR.R.AAAAAAAAAAAAAAAAAAAAAAAAAAARAAAAAAAAAAAAAAAAAAAAAAAAAAAAAAAAAAAAAAAAAAAAAAAAAAAAA
AAAAAAAAAAAAAAAAAAAAAAAAAAAAAA...R..R.FFFFFFFFFAAAAAAAAAAAAAAAAAAAAAAAAAAAAA.A..A..AAAAR...AAAAAAAAAAAAAAAAAAAAAA....AAAAAAAAAAAAAAAAAAAAAAAAAAAAAAAAAAAAAAAAAAAAAAAAAAAAAAAAAAAAAAAAAAAAAAAAAAAAAAAAAAA
AAAAAAAAAAAAAAAAAAAAAAAAAAAAAAAAAAAAAA.R.RFFFFFFAAAAAAAAAAAAAAAAAAAAAAAAAAAAAAAAAAAAAAR..7..AAAAAAAAAAAAAAAAAAAAAAAAAAAAAAAAAAAAAAAAAAAAAAAAAAAAAAAAAAAAAAAAAAAAAAAAAAAAAAAAAAAAAAAAAAAAAAAAAAAAAAAAAAAA
AAAAAAAAAAAAAAAAAAAAAAAAAAAAAAAAAAAAAAAAAA..FFFFAAAAAAAAAAAAAAAAAAAAAAAAAAAAAAAAAAAAAAAAAR.AAAAAAAAAAAAAAAAAAAAAAAAAAAAAAAAAAAAAAAAAAAAAAAAAAAAAAAAAAAAAAAAAAAAAAAAAAAAAAAAAAAAAAAAAAAAAAAAAAAAAAAAAAAAA
AAAAAAAAAAAAAAAAAAAAAAAAAAAAAAAAAAAAAAAAAAAAA.AAAAAAAAAAAAAAAAAAAAAAAAAAAAAAAAAAAAAAAAAAAAAAAAAAAAAAAAAAAAAAAAAAAAAAAAAAAAAAAAAAAAAAAAAAAAAAAAAAAAAAAAAAAAAAAAAAAAAAAAAAAAAAAAAAAAAAAAAAAAAAAAAAAAAAAAAA